State,Year,Undergrad,Professional,Grad,Total
Alabama,2017,20,2,14,36
Alabama,2016,17,2,15,34
Alabama,2015,15,1,15,31
Alabama,2014,10,0,17,27
Alabama,2013,7,1,11,19
Alabama,2012,9,1,10,20
Alabama,2011,15,2,10,27
Alabama,2010,13,2,7,22
Alabama,2009,13,2,7,22
Alabama,2008,12,2,8,22
Alabama,2007,11,3,9,23
Alabama,2006,11,1,9,21
Alabama,2005,16,0,5,21
Alabama,2004,16,0,8,24
Alabama,2003,23,0,26,49
Alabama,2002,22,0,23,45
Alabama,2001,21,0,20,41
Alabama,2000,20,1,21,42
Alabama,1999,19,2,21,42
Alabama,1998,13,2,18,33
Alaska,2017,5,0,6,11
Alaska,2016,3,0,4,7
Alaska,2015,2,0,5,7
Alaska,2014,3,0,7,10
Alaska,2013,3,0,3,6
Alaska,2012,5,0,4,9
Alaska,2011,6,0,4,10
Alaska,2010,6,1,5,12
Alaska,2009,6,1,5,12
Alaska,2008,3,2,4,9
Alaska,2007,2,0,4,6
Alaska,2006,3,1,4,8
Alaska,2005,5,1,3,9
Alaska,2004,4,1,1,6
Alaska,2003,5,1,8,14
Alaska,2002,5,0,5,10
Alaska,2001,5,0,11,16
Alaska,2000,5,0,11,16
Alaska,1999,5,0,14,19
Alaska,1998,5,0,7,12
Arizona,2017,39,7,59,105
Arizona,2016,34,5,31,70
Arizona,2015,37,3,26,66
Arizona,2014,28,3,21,52
Arizona,2013,18,3,22,43
Arizona,2012,22,3,17,42
Arizona,2011,15,2,17,34
Arizona,2010,20,4,16,40
Arizona,2009,20,4,16,40
Arizona,2008,19,6,7,32
Arizona,2007,17,4,8,29
Arizona,2006,25,6,9,40
Arizona,2005,26,4,13,43
Arizona,2004,22,2,16,40
Arizona,2003,24,1,35,60
Arizona,2002,22,3,27,52
Arizona,2001,21,3,26,50
Arizona,2000,14,1,26,41
Arizona,1999,12,4,23,39
Arizona,1998,11,4,20,35
Arkansas,2017,6,2,14,22
Arkansas,2016,10,1,13,24
Arkansas,2015,9,1,12,22
Arkansas,2014,10,1,8,19
Arkansas,2013,12,2,10,24
Arkansas,2012,10,2,12,24
Arkansas,2011,10,2,9,21
Arkansas,2010,8,2,6,16
Arkansas,2009,8,2,6,16
Arkansas,2008,3,2,10,15
Arkansas,2007,8,2,12,22
Arkansas,2006,9,0,11,20
Arkansas,2005,13,0,10,23
Arkansas,2004,17,0,6,23
Arkansas,2003,14,0,20,34
Arkansas,2002,11,1,16,28
Arkansas,2001,8,1,16,25
Arkansas,2000,11,3,19,33
Arkansas,1999,14,2,23,39
Arkansas,1998,14,2,18,34
California,2017,1011,43,425,1479
California,2016,937,42,226,1205
California,2015,828,38,232,1098
California,2014,643,37,204,884
California,2013,490,33,169,692
California,2012,366,40,172,578
California,2011,262,43,161,466
California,2010,187,48,161,396
California,2009,187,48,161,396
California,2008,145,25,136,306
California,2007,152,22,121,295
California,2006,158,21,122,301
California,2005,159,27,112,298
California,2004,179,32,83,294
California,2003,176,35,251,462
California,2002,155,34,221,410
California,2001,146,28,223,397
California,2000,121,28,233,382
California,1999,102,28,215,345
California,1998,108,26,211,345
Colorado,2017,47,5,67,119
Colorado,2016,52,3,33,88
Colorado,2015,52,0,33,85
Colorado,2014,51,2,27,80
Colorado,2013,47,6,16,69
Colorado,2012,41,6,16,63
Colorado,2011,28,10,15,53
Colorado,2010,23,6,20,49
Colorado,2009,23,6,20,49
Colorado,2008,20,4,15,39
Colorado,2007,20,1,14,35
Colorado,2006,27,1,15,43
Colorado,2005,30,2,17,49
Colorado,2004,30,3,12,45
Colorado,2003,35,8,36,79
Colorado,2002,39,7,42,88
Colorado,2001,30,7,42,79
Colorado,2000,31,5,45,81
Colorado,1999,33,3,46,82
Colorado,1998,26,2,41,69
Connecticut,2017,40,6,39,85
Connecticut,2016,43,4,21,68
Connecticut,2015,40,3,22,65
Connecticut,2014,34,3,19,56
Connecticut,2013,39,4,20,63
Connecticut,2012,31,4,17,52
Connecticut,2011,35,5,24,64
Connecticut,2010,32,3,21,56
Connecticut,2009,32,3,21,56
Connecticut,2008,28,4,17,49
Connecticut,2007,21,3,13,37
Connecticut,2006,22,4,13,39
Connecticut,2005,24,3,12,39
Connecticut,2004,18,4,9,31
Connecticut,2003,34,7,34,75
Connecticut,2002,32,7,26,65
Connecticut,2001,29,6,21,56
Connecticut,2000,35,6,24,65
Connecticut,1999,27,3,24,54
Connecticut,1998,30,3,25,58
Delaware,2017,5,0,3,8
Delaware,2016,6,0,3,9
Delaware,2015,4,0,4,8
Delaware,2014,7,0,5,12
Delaware,2013,6,0,5,11
Delaware,2012,6,0,7,13
Delaware,2011,2,1,5,8
Delaware,2010,1,1,6,8
Delaware,2009,1,1,6,8
Delaware,2008,5,0,5,10
Delaware,2007,7,0,5,12
Delaware,2006,5,0,4,9
Delaware,2005,4,0,2,6
Delaware,2004,4,0,2,6
Delaware,2003,2,0,3,5
Delaware,2002,4,1,5,10
Delaware,2001,4,1,6,11
Delaware,2000,5,1,5,11
Delaware,1999,4,0,8,12
Delaware,1998,4,0,7,11
District of Columbia,2017,2,1,9,12
District of Columbia,2016,4,2,3,9
District of Columbia,2015,5,1,4,10
District of Columbia,2014,5,1,4,10
District of Columbia,2013,2,1,4,7
District of Columbia,2012,3,0,5,8
District of Columbia,2011,5,0,4,9
District of Columbia,2010,10,0,6,16
District of Columbia,2009,10,0,6,16
District of Columbia,2008,12,0,6,18
District of Columbia,2007,8,0,6,14
District of Columbia,2006,7,1,1,9
District of Columbia,2005,2,0,1,3
District of Columbia,2004,2,1,5,8
District of Columbia,2003,3,0,7,10
District of Columbia,2002,2,1,8,11
District of Columbia,2001,2,2,9,13
District of Columbia,2000,3,2,13,18
District of Columbia,1999,2,2,8,12
District of Columbia,1998,2,1,7,10
Florida,2017,89,20,101,210
Florida,2016,99,26,56,181
Florida,2015,111,17,47,175
Florida,2014,97,11,47,155
Florida,2013,80,16,56,152
Florida,2012,81,17,58,156
Florida,2011,69,19,66,154
Florida,2010,67,15,68,150
Florida,2009,67,15,68,150
Florida,2008,50,8,60,118
Florida,2007,43,11,50,104
Florida,2006,42,8,44,94
Florida,2005,55,5,31,91
Florida,2004,56,3,23,82
Florida,2003,55,8,73,136
Florida,2002,51,10,72,133
Florida,2001,58,10,67,135
Florida,2000,58,9,60,127
Florida,1999,50,8,62,120
Florida,1998,50,3,61,114
Georgia,2017,89,4,56,149
Georgia,2016,81,3,33,117
Georgia,2015,59,3,31,93
Georgia,2014,54,4,31,89
Georgia,2013,44,5,23,72
Georgia,2012,45,4,24,73
Georgia,2011,46,5,27,78
Georgia,2010,31,4,32,67
Georgia,2009,31,4,32,67
Georgia,2008,28,3,27,58
Georgia,2007,25,5,25,55
Georgia,2006,31,6,24,61
Georgia,2005,21,5,27,53
Georgia,2004,26,1,21,48
Georgia,2003,26,3,41,70
Georgia,2002,32,2,43,77
Georgia,2001,18,5,38,61
Georgia,2000,23,5,44,72
Georgia,1999,21,6,41,68
Georgia,1998,23,3,39,65
Guam,2017,1,0,0,1
Guam,2016,1,0,0,1
Guam,2015,1,0,1,2
Guam,2014,1,0,1,2
Guam,2013,0,0,1,1
Hawaii,2017,9,0,10,19
Hawaii,2016,8,0,9,17
Hawaii,2015,7,0,8,15
Hawaii,2014,7,0,7,14
Hawaii,2013,9,1,10,20
Hawaii,2012,6,1,10,17
Hawaii,2011,5,1,8,14
Hawaii,2010,6,1,9,16
Hawaii,2009,6,1,9,16
Hawaii,2008,6,1,6,13
Hawaii,2007,6,1,5,12
Hawaii,2006,8,0,5,13
Hawaii,2005,13,0,4,17
Hawaii,2004,13,0,3,16
Hawaii,2003,23,1,7,31
Hawaii,2002,34,0,6,40
Hawaii,2001,40,0,7,47
Hawaii,2000,54,0,8,62
Hawaii,1999,54,0,12,66
Hawaii,1998,58,0,6,64
Idaho,2017,5,1,14,20
Idaho,2016,3,1,12,16
Idaho,2015,2,1,8,11
Idaho,2014,5,1,8,14
Idaho,2013,1,1,6,8
Idaho,2012,2,2,7,11
Idaho,2011,3,3,10,16
Idaho,2010,2,2,10,14
Idaho,2009,2,2,10,14
Idaho,2008,2,1,10,13
Idaho,2007,2,1,8,11
Idaho,2006,3,2,6,11
Idaho,2005,5,0,5,10
Idaho,2004,3,1,3,7
Idaho,2003,4,0,8,12
Idaho,2002,2,0,8,10
Idaho,2001,2,0,8,10
Idaho,2000,2,0,8,10
Idaho,1999,3,0,6,9
Idaho,1998,3,0,6,9
Illinois,2017,24251,537,3330,28118
Illinois,2016,24169,542,2458,27169
Illinois,2015,23720,607,2580,26907
Illinois,2014,23853,630,2677,27160
Illinois,2013,24299,677,2825,27801
Illinois,2012,24683,701,2839,28223
Illinois,2011,25197,687,2845,28729
Illinois,2010,25465,704,2901,29070
Illinois,2009,25465,704,2901,29070
Illinois,2008,26677,707,2903,30287
Illinois,2007,26848,686,2894,30428
Illinois,2006,27049,703,2828,30580
Illinois,2005,26539,718,2807,30064
Illinois,2004,25494,805,2941,29240
Illinois,2003,25129,825,3084,29038
Illinois,2002,25085,824,3091,29000
Illinois,2001,25106,835,2904,28845
Illinois,2000,25150,787,2787,28724
Illinois,1999,25222,766,2868,28856
Illinois,1998,24807,760,3096,28663
Indiana,2017,65,17,103,185
Indiana,2016,58,16,80,154
Indiana,2015,62,12,76,150
Indiana,2014,58,9,73,140
Indiana,2013,57,11,68,136
Indiana,2012,56,11,78,145
Indiana,2011,55,11,66,132
Indiana,2010,49,6,63,118
Indiana,2009,49,6,63,118
Indiana,2008,65,3,68,136
Indiana,2007,74,4,75,153
Indiana,2006,79,3,57,139
Indiana,2005,89,1,48,138
Indiana,2004,95,5,47,147
Indiana,2003,86,8,123,217
Indiana,2002,91,8,125,224
Indiana,2001,87,7,122,216
Indiana,2000,90,9,107,206
Indiana,1999,98,9,103,210
Indiana,1998,90,10,98,198
Iowa,2017,39,3,43,85
Iowa,2016,35,3,39,77
Iowa,2015,28,1,40,69
Iowa,2014,29,2,49,80
Iowa,2013,27,3,51,81
Iowa,2012,20,2,46,68
Iowa,2011,32,1,48,81
Iowa,2010,26,2,53,81
Iowa,2009,26,2,53,81
Iowa,2008,29,5,45,79
Iowa,2007,34,4,42,80
Iowa,2006,41,4,37,82
Iowa,2005,40,3,29,72
Iowa,2004,33,2,34,69
Iowa,2003,34,2,76,112
Iowa,2002,31,2,70,103
Iowa,2001,35,3,59,97
Iowa,2000,40,2,50,92
Iowa,1999,47,3,53,103
Iowa,1998,39,2,59,100
Kansas,2017,24,2,26,52
Kansas,2016,25,2,15,42
Kansas,2015,19,2,22,43
Kansas,2014,22,1,30,53
Kansas,2013,23,1,29,53
Kansas,2012,20,2,18,40
Kansas,2011,25,3,15,43
Kansas,2010,33,5,14,52
Kansas,2009,33,5,14,52
Kansas,2008,38,1,15,54
Kansas,2007,34,0,25,59
Kansas,2006,35,2,29,66
Kansas,2005,37,2,24,63
Kansas,2004,41,2,15,58
Kansas,2003,46,2,45,93
Kansas,2002,34,3,40,77
Kansas,2001,41,4,37,82
Kansas,2000,35,2,32,69
Kansas,1999,27,2,24,53
Kansas,1998,31,1,25,57
Kentucky,2017,30,3,24,57
Kentucky,2016,30,3,23,56
Kentucky,2015,32,3,23,58
Kentucky,2014,33,3,25,61
Kentucky,2013,28,3,26,57
Kentucky,2012,25,4,20,49
Kentucky,2011,23,3,22,48
Kentucky,2010,15,4,24,43
Kentucky,2009,15,4,24,43
Kentucky,2008,25,2,27,54
Kentucky,2007,28,2,22,52
Kentucky,2006,38,1,26,65
Kentucky,2005,40,4,21,65
Kentucky,2004,30,3,16,49
Kentucky,2003,36,4,36,76
Kentucky,2002,34,2,35,71
Kentucky,2001,37,1,35,73
Kentucky,2000,42,0,33,75
Kentucky,1999,43,2,23,68
Kentucky,1998,34,3,22,59
Louisiana,2017,9,2,20,31
Louisiana,2016,10,2,16,28
Louisiana,2015,12,1,12,25
Louisiana,2014,13,1,15,29
Louisiana,2013,14,1,14,29
Louisiana,2012,8,2,10,20
Louisiana,2011,5,2,8,15
Louisiana,2010,6,2,10,18
Louisiana,2009,6,2,10,18
Louisiana,2008,4,1,14,19
Louisiana,2007,7,2,15,24
Louisiana,2006,12,2,11,25
Louisiana,2005,10,0,9,19
Louisiana,2004,12,0,9,21
Louisiana,2003,8,2,26,36
Louisiana,2002,8,2,19,29
Louisiana,2001,10,2,20,32
Louisiana,2000,12,2,21,35
Louisiana,1999,7,0,15,22
Louisiana,1998,13,0,13,26
Maine,2017,3,0,12,15
Maine,2016,5,0,9,14
Maine,2015,4,2,8,14
Maine,2014,3,1,6,10
Maine,2013,3,1,4,8
Maine,2012,5,3,2,10
Maine,2011,2,1,5,8
Maine,2010,2,1,7,10
Maine,2009,2,1,7,10
Maine,2008,3,1,6,10
Maine,2007,2,0,6,8
Maine,2006,2,0,4,6
Maine,2005,3,0,5,8
Maine,2004,5,1,2,8
Maine,2003,8,2,7,17
Maine,2002,6,1,9,16
Maine,2001,4,1,12,17
Maine,2000,6,0,7,13
Maine,1999,3,1,8,12
Maine,1998,3,2,9,14
Maryland,2017,62,5,69,136
Maryland,2016,66,7,46,119
Maryland,2015,73,5,45,123
Maryland,2014,78,7,43,128
Maryland,2013,74,5,45,124
Maryland,2012,67,6,41,114
Maryland,2011,67,4,47,118
Maryland,2010,62,2,41,105
Maryland,2009,62,2,41,105
Maryland,2008,74,3,43,120
Maryland,2007,76,4,41,121
Maryland,2006,80,5,40,125
Maryland,2005,85,7,36,128
Maryland,2004,89,9,30,128
Maryland,2003,100,8,60,168
Maryland,2002,81,6,54,141
Maryland,2001,79,7,53,139
Maryland,2000,69,5,46,120
Maryland,1999,66,1,41,108
Maryland,1998,77,3,44,124
Massachusetts,2017,98,14,72,184
Massachusetts,2016,105,10,45,160
Massachusetts,2015,106,9,33,148
Massachusetts,2014,102,10,36,148
Massachusetts,2013,100,7,34,141
Massachusetts,2012,94,8,42,144
Massachusetts,2011,92,5,38,135
Massachusetts,2010,80,3,35,118
Massachusetts,2009,80,3,35,118
Massachusetts,2008,65,3,20,88
Massachusetts,2007,59,3,22,84
Massachusetts,2006,51,5,15,71
Massachusetts,2005,56,3,20,79
Massachusetts,2004,53,9,25,87
Massachusetts,2003,51,10,69,130
Massachusetts,2002,43,10,65,118
Massachusetts,2001,48,8,60,116
Massachusetts,2000,48,5,48,101
Massachusetts,1999,45,4,56,105
Massachusetts,1998,48,6,47,101
Michigan,2017,86,41,131,258
Michigan,2016,81,46,101,228
Michigan,2015,76,39,110,225
Michigan,2014,85,34,114,233
Michigan,2013,83,29,105,217
Michigan,2012,63,36,89,188
Michigan,2011,65,40,82,187
Michigan,2010,50,38,84,172
Michigan,2009,50,38,84,172
Michigan,2008,60,17,75,152
Michigan,2007,63,17,55,135
Michigan,2006,79,17,67,163
Michigan,2005,68,14,65,147
Michigan,2004,68,20,54,142
Michigan,2003,71,27,134,232
Michigan,2002,68,21,119,208
Michigan,2001,67,18,106,191
Michigan,2000,56,15,98,169
Michigan,1999,54,14,99,167
Michigan,1998,62,12,102,176
Military,2006,1,0,0,1
Military,2005,2,0,0,2
Military,2004,6,0,0,6
Military,2017,6,1,3,10
Military,2016,8,0,1,9
Military,2015,7,0,3,10
Military,2014,6,0,1,7
Military,2013,4,0,1,5
Military,2012,7,0,0,7
Military,2011,11,0,0,11
Military,2010,7,0,0,7
Military,2009,7,0,0,7
Military,2008,6,0,0,6
Military,2007,3,0,0,3
Military,2003,1,0,2,3
Military,2002,1,0,1,2
Military,2001,0,0,0,0
Military,2000,1,0,0,1
Minnesota,2017,77,7,77,161
Minnesota,2016,80,9,52,141
Minnesota,2015,71,4,51,126
Minnesota,2014,69,5,50,124
Minnesota,2013,53,6,49,108
Minnesota,2012,58,6,48,112
Minnesota,2011,56,6,53,115
Minnesota,2010,43,4,60,107
Minnesota,2009,43,4,60,107
Minnesota,2008,37,3,43,83
Minnesota,2007,39,0,43,82
Minnesota,2006,44,2,38,84
Minnesota,2005,48,1,25,74
Minnesota,2004,60,2,25,87
Minnesota,2003,58,0,89,147
Minnesota,2002,64,0,77,141
Minnesota,2001,72,0,75,147
Minnesota,2000,69,0,64,133
Minnesota,1999,73,2,63,138
Minnesota,1998,56,2,67,125
Mississippi,2017,6,0,10,16
Mississippi,2016,5,0,6,11
Mississippi,2015,4,0,6,10
Mississippi,2014,3,0,8,11
Mississippi,2013,6,0,10,16
Mississippi,2012,5,1,8,14
Mississippi,2011,4,1,7,12
Mississippi,2010,2,1,8,11
Mississippi,2009,2,1,8,11
Mississippi,2008,5,0,5,10
Mississippi,2007,6,0,3,9
Mississippi,2006,4,1,4,9
Mississippi,2005,5,1,5,11
Mississippi,2004,4,0,4,8
Mississippi,2003,1,0,13,14
Mississippi,2002,3,0,14,17
Mississippi,2001,2,0,12,14
Mississippi,2000,4,0,12,16
Mississippi,1999,2,0,13,15
Mississippi,1998,4,0,18,22
Missouri,2017,122,10,127,259
Missouri,2016,134,6,75,215
Missouri,2015,138,9,67,214
Missouri,2014,141,10,73,224
Missouri,2013,138,9,84,231
Missouri,2012,140,12,92,244
Missouri,2011,133,11,78,222
Missouri,2010,133,12,82,227
Missouri,2009,133,12,82,227
Missouri,2008,167,8,72,247
Missouri,2007,174,9,67,250
Missouri,2006,202,8,66,276
Missouri,2005,227,6,45,278
Missouri,2004,244,5,41,290
Missouri,2003,289,4,123,416
Missouri,2002,286,6,109,401
Missouri,2001,298,3,113,414
Missouri,2000,284,5,103,392
Missouri,1999,284,9,106,399
Missouri,1998,288,14,107,409
Montana,2017,1,0,3,4
Montana,2016,0,0,4,4
Montana,2015,0,0,3,3
Montana,2014,0,0,3,3
Montana,2013,0,0,3,3
Montana,2012,0,0,6,6
Montana,2011,0,0,6,6
Montana,2010,1,0,4,5
Montana,2009,1,0,4,5
Montana,2008,1,0,3,4
Montana,2007,1,0,3,4
Montana,2006,0,0,2,2
Montana,2005,1,0,2,3
Montana,2004,3,0,5,8
Montana,2003,2,1,7,10
Montana,2002,4,1,8,13
Montana,2001,1,1,9,11
Montana,2000,2,1,7,10
Montana,1999,3,1,5,9
Montana,1998,2,1,3,6
Nebraska,2017,7,1,28,36
Nebraska,2016,7,3,18,28
Nebraska,2015,5,2,19,26
Nebraska,2014,11,1,16,28
Nebraska,2013,10,0,16,26
Nebraska,2012,11,1,14,26
Nebraska,2011,12,2,14,28
Nebraska,2010,8,2,22,32
Nebraska,2009,8,2,22,32
Nebraska,2008,14,2,15,31
Nebraska,2007,15,2,18,35
Nebraska,2006,20,2,17,39
Nebraska,2005,18,1,14,33
Nebraska,2004,18,1,11,30
Nebraska,2003,21,0,26,47
Nebraska,2002,28,1,26,55
Nebraska,2001,29,1,28,58
Nebraska,2000,37,1,20,58
Nebraska,1999,42,0,14,56
Nebraska,1998,39,1,16,56
Nevada,2017,11,3,7,21
Nevada,2016,8,3,5,16
Nevada,2015,8,2,6,16
Nevada,2014,9,1,5,15
Nevada,2013,8,1,4,13
Nevada,2012,9,1,6,16
Nevada,2011,9,0,5,14
Nevada,2010,8,0,6,14
Nevada,2009,8,0,6,14
Nevada,2008,11,0,3,14
Nevada,2007,11,0,4,15
Nevada,2006,10,0,2,12
Nevada,2005,7,0,1,8
Nevada,2004,6,1,1,8
Nevada,2003,11,2,4,17
Nevada,2002,11,2,3,16
Nevada,2001,10,1,4,15
Nevada,2000,12,0,8,20
Nevada,1999,10,0,8,18
Nevada,1998,10,0,3,13
New Hampshire,2017,16,1,10,27
New Hampshire,2016,17,1,7,25
New Hampshire,2015,13,1,11,25
New Hampshire,2014,11,1,12,24
New Hampshire,2013,10,2,15,27
New Hampshire,2012,8,1,13,22
New Hampshire,2011,7,1,11,19
New Hampshire,2010,9,0,8,17
New Hampshire,2009,9,0,8,17
New Hampshire,2008,9,1,5,15
New Hampshire,2007,12,1,3,16
New Hampshire,2006,15,2,4,21
New Hampshire,2005,12,2,3,17
New Hampshire,2004,7,2,2,11
New Hampshire,2003,8,3,12,23
New Hampshire,2002,7,2,12,21
New Hampshire,2001,5,2,11,18
New Hampshire,2000,5,2,12,19
New Hampshire,1999,5,0,11,16
New Hampshire,1998,4,0,10,14
New Jersey,2017,328,14,88,430
New Jersey,2016,312,17,49,378
New Jersey,2015,317,13,42,372
New Jersey,2014,280,14,44,338
New Jersey,2013,243,8,48,299
New Jersey,2012,207,8,49,264
New Jersey,2011,195,11,45,251
New Jersey,2010,169,13,41,223
New Jersey,2009,169,13,41,223
New Jersey,2008,157,12,31,200
New Jersey,2007,130,15,29,174
New Jersey,2006,138,15,32,185
New Jersey,2005,154,14,28,196
New Jersey,2004,158,12,28,198
New Jersey,2003,155,10,76,241
New Jersey,2002,125,8,71,204
New Jersey,2001,125,8,75,208
New Jersey,2000,110,7,74,191
New Jersey,1999,108,10,60,178
New Jersey,1998,117,6,57,180
New Mexico,2017,8,0,24,32
New Mexico,2016,8,1,18,27
New Mexico,2015,7,1,11,19
New Mexico,2014,6,1,10,17
New Mexico,2013,3,1,11,15
New Mexico,2012,7,0,12,19
New Mexico,2011,7,0,13,20
New Mexico,2010,4,0,14,18
New Mexico,2009,4,0,14,18
New Mexico,2008,3,0,16,19
New Mexico,2007,6,1,13,20
New Mexico,2006,5,2,10,17
New Mexico,2005,7,2,9,18
New Mexico,2004,9,1,9,19
New Mexico,2003,10,0,24,34
New Mexico,2002,10,0,24,34
New Mexico,2001,7,0,23,30
New Mexico,2000,7,0,25,32
New Mexico,1999,14,1,29,44
New Mexico,1998,12,1,28,41
New York,2017,176,19,154,349
New York,2016,176,19,98,293
New York,2015,182,12,98,292
New York,2014,166,16,99,281
New York,2013,137,16,106,259
New York,2012,125,22,101,248
New York,2011,98,23,92,213
New York,2010,90,23,79,192
New York,2009,90,23,79,192
New York,2008,76,16,73,165
New York,2007,72,15,75,162
New York,2006,84,18,81,183
New York,2005,100,12,56,168
New York,2004,102,10,56,168
New York,2003,121,15,153,289
New York,2002,122,20,153,295
New York,2001,119,16,135,270
New York,2000,115,23,136,274
New York,1999,119,21,131,271
New York,1998,120,17,143,280
North Carolina,2017,31,3,57,91
North Carolina,2016,28,1,44,73
North Carolina,2015,26,1,38,65
North Carolina,2014,26,1,36,63
North Carolina,2013,24,1,32,57
North Carolina,2012,25,1,32,58
North Carolina,2011,27,3,28,58
North Carolina,2010,18,5,31,54
North Carolina,2009,18,5,31,54
North Carolina,2008,25,4,36,65
North Carolina,2007,16,3,27,46
North Carolina,2006,20,4,24,48
North Carolina,2005,26,1,26,53
North Carolina,2004,25,1,33,59
North Carolina,2003,22,12,60,94
North Carolina,2002,22,7,43,72
North Carolina,2001,19,5,43,67
North Carolina,2000,16,3,46,65
North Carolina,1999,14,2,47,63
North Carolina,1998,19,3,43,65
North Dakota,2017,0,1,4,5
North Dakota,2016,1,0,1,2
North Dakota,2015,0,1,1,2
North Dakota,2014,0,1,4,5
North Dakota,2013,0,1,4,5
North Dakota,2012,0,0,3,3
North Dakota,2011,0,0,6,6
North Dakota,2010,1,0,5,6
North Dakota,2009,1,0,5,6
North Dakota,2008,1,1,3,5
North Dakota,2007,3,1,3,7
North Dakota,2006,3,0,1,4
North Dakota,2005,2,0,3,5
North Dakota,2004,3,0,2,5
North Dakota,2003,5,0,6,11
North Dakota,2002,3,0,6,9
North Dakota,2001,5,0,6,11
North Dakota,2000,4,1,7,12
North Dakota,1999,2,1,5,8
North Dakota,1998,1,0,6,7
Ohio,2017,101,22,103,226
Ohio,2016,129,13,79,221
Ohio,2015,144,13,84,241
Ohio,2014,135,7,76,218
Ohio,2013,123,13,74,210
Ohio,2012,127,17,66,210
Ohio,2011,126,21,69,216
Ohio,2010,121,19,74,214
Ohio,2009,121,19,74,214
Ohio,2008,113,12,75,200
Ohio,2007,104,12,65,181
Ohio,2006,115,8,69,192
Ohio,2005,131,3,72,206
Ohio,2004,139,4,56,199
Ohio,2003,161,7,136,304
Ohio,2002,161,11,124,296
Ohio,2001,161,10,129,300
Ohio,2000,174,11,139,324
Ohio,1999,189,7,121,317
Ohio,1998,205,10,127,342
Oklahoma,2017,17,0,13,30
Oklahoma,2016,18,0,7,25
Oklahoma,2015,17,0,5,22
Oklahoma,2014,12,1,8,21
Oklahoma,2013,15,1,4,20
Oklahoma,2012,12,1,9,22
Oklahoma,2011,9,1,12,22
Oklahoma,2010,12,1,9,22
Oklahoma,2009,12,1,9,22
Oklahoma,2008,10,0,9,19
Oklahoma,2007,17,0,6,23
Oklahoma,2006,23,1,10,34
Oklahoma,2005,22,1,10,33
Oklahoma,2004,28,2,6,36
Oklahoma,2003,20,0,29,49
Oklahoma,2002,19,0,30,49
Oklahoma,2001,21,0,35,56
Oklahoma,2000,17,0,35,52
Oklahoma,1999,20,0,34,54
Oklahoma,1998,17,0,34,51
Oregon,2017,17,0,41,58
Oregon,2016,16,1,21,38
Oregon,2015,19,3,17,39
Oregon,2014,19,5,12,36
Oregon,2013,19,3,17,39
Oregon,2012,16,4,12,32
Oregon,2011,12,4,19,35
Oregon,2010,12,2,19,33
Oregon,2009,12,2,19,33
Oregon,2008,7,1,15,23
Oregon,2007,5,1,16,22
Oregon,2006,15,1,14,30
Oregon,2005,15,0,11,26
Oregon,2004,17,1,10,28
Oregon,2003,19,2,27,48
Oregon,2002,14,1,26,41
Oregon,2001,19,1,23,43
Oregon,2000,16,1,28,45
Oregon,1999,13,0,26,39
Oregon,1998,13,0,29,42
Other US,2012,3,1,20,24
Other US,2011,8,1,19,28
Other US,2010,4,1,22,27
Other US,2009,4,1,22,27
Other US,2008,13,0,17,30
Other US,2007,11,0,17,28
Other US,2006,13,0,19,32
Other US,2005,10,0,19,29
Other US,2004,8,1,17,26
Other US,2003,7,2,31,40
Other US,2002,15,2,28,45
Other US,2001,17,3,27,47
Other US,2000,17,4,34,55
Other US,1999,17,2,21,40
Other US,1998,14,1,19,34
Pennsylvania,2017,68,14,83,165
Pennsylvania,2016,75,10,54,139
Pennsylvania,2015,78,9,62,149
Pennsylvania,2014,73,9,70,152
Pennsylvania,2013,62,8,74,144
Pennsylvania,2012,59,14,70,143
Pennsylvania,2011,56,21,69,146
Pennsylvania,2010,48,19,65,132
Pennsylvania,2009,48,19,65,132
Pennsylvania,2008,45,6,49,100
Pennsylvania,2007,32,8,38,78
Pennsylvania,2006,39,7,35,81
Pennsylvania,2005,55,5,42,102
Pennsylvania,2004,54,5,44,103
Pennsylvania,2003,62,8,109,179
Pennsylvania,2002,61,6,95,162
Pennsylvania,2001,57,7,91,155
Pennsylvania,2000,57,6,98,161
Pennsylvania,1999,60,7,85,152
Pennsylvania,1998,53,4,74,131
Puerto Rico,2017,3,3,20,26
Puerto Rico,2016,6,1,19,26
Puerto Rico,2015,5,1,20,26
Puerto Rico,2014,6,1,17,24
Puerto Rico,2013,4,0,17,21
Rhode Island,2017,6,0,6,12
Rhode Island,2016,2,0,5,7
Rhode Island,2015,2,0,5,7
Rhode Island,2014,3,0,7,10
Rhode Island,2013,2,0,8,10
Rhode Island,2012,2,0,9,11
Rhode Island,2011,4,0,11,15
Rhode Island,2010,4,1,9,14
Rhode Island,2009,4,1,9,14
Rhode Island,2008,3,1,6,10
Rhode Island,2007,4,0,1,5
Rhode Island,2006,2,0,1,3
Rhode Island,2005,2,0,2,4
Rhode Island,2004,3,0,1,4
Rhode Island,2003,4,1,6,11
Rhode Island,2002,5,3,4,12
Rhode Island,2001,4,3,3,10
Rhode Island,2000,7,2,9,18
Rhode Island,1999,7,2,9,18
Rhode Island,1998,6,1,8,15
South Carolina,2017,7,2,17,26
South Carolina,2016,5,2,15,22
South Carolina,2015,5,4,16,25
South Carolina,2014,8,1,16,25
South Carolina,2013,8,2,14,24
South Carolina,2012,5,1,10,16
South Carolina,2011,3,2,13,18
South Carolina,2010,7,2,8,17
South Carolina,2009,7,2,8,17
South Carolina,2008,12,1,15,28
South Carolina,2007,9,1,17,27
South Carolina,2006,7,0,13,20
South Carolina,2005,10,0,14,24
South Carolina,2004,10,0,3,13
South Carolina,2003,10,1,12,23
South Carolina,2002,9,1,10,20
South Carolina,2001,9,2,10,21
South Carolina,2000,7,2,14,23
South Carolina,1999,12,3,12,27
South Carolina,1998,12,2,15,29
South Dakota,2017,3,1,4,8
South Dakota,2016,2,0,4,6
South Dakota,2015,3,0,8,11
South Dakota,2014,6,0,7,13
South Dakota,2013,5,1,7,13
South Dakota,2012,5,1,6,12
South Dakota,2011,5,2,3,10
South Dakota,2010,1,1,2,4
South Dakota,2009,1,1,2,4
South Dakota,2008,1,0,4,5
South Dakota,2007,1,0,6,7
South Dakota,2006,3,0,3,6
South Dakota,2005,4,0,2,6
South Dakota,2004,5,0,0,5
South Dakota,2003,5,0,3,8
South Dakota,2002,4,0,4,8
South Dakota,2001,5,1,5,11
South Dakota,2000,5,2,4,11
South Dakota,1999,6,2,6,14
South Dakota,1998,5,2,6,13
Tennessee,2017,45,4,53,102
Tennessee,2016,46,2,36,84
Tennessee,2015,43,4,27,74
Tennessee,2014,42,4,25,71
Tennessee,2013,39,3,27,69
Tennessee,2012,37,3,30,70
Tennessee,2011,35,2,28,65
Tennessee,2010,25,2,29,56
Tennessee,2009,25,2,29,56
Tennessee,2008,28,1,36,65
Tennessee,2007,25,3,22,50
Tennessee,2006,28,3,21,52
Tennessee,2005,38,3,17,58
Tennessee,2004,41,2,9,52
Tennessee,2003,43,1,42,86
Tennessee,2002,44,1,47,92
Tennessee,2001,41,1,39,81
Tennessee,2000,35,2,37,74
Tennessee,1999,43,2,37,82
Tennessee,1998,52,1,46,99
Texas,2017,162,18,188,368
Texas,2016,164,16,92,272
Texas,2015,148,13,81,242
Texas,2014,119,17,85,221
Texas,2013,121,17,84,222
Texas,2012,109,19,89,217
Texas,2011,100,25,89,214
Texas,2010,87,25,76,188
Texas,2009,87,25,76,188
Texas,2008,102,14,66,182
Texas,2007,92,10,70,172
Texas,2006,85,13,71,169
Texas,2005,87,12,48,147
Texas,2004,93,7,41,141
Texas,2003,85,5,136,226
Texas,2002,72,4,126,202
Texas,2001,55,6,103,164
Texas,2000,47,6,98,151
Texas,1999,57,7,87,151
Texas,1998,53,5,100,158
Unknown,2017,282,59,1435,1776
Unknown,2016,525,65,1146,1736
Unknown,2015,548,48,1177,1773
Unknown,2014,596,52,1214,1862
Unknown,2013,574,52,1253,1879
Unknown,2012,606,72,1269,1947
Unknown,2011,624,84,1325,2033
Unknown,2010,612,79,1432,2123
Unknown,2009,612,79,1432,2123
Unknown,2008,568,103,1546,2217
Unknown,2007,486,113,1581,2180
Unknown,2006,498,132,1659,2289
Unknown,2005,508,141,1804,2453
Unknown,2004,473,82,1851,2406
Utah,2017,7,0,21,28
Utah,2016,7,0,14,21
Utah,2015,8,0,15,23
Utah,2014,6,0,16,22
Utah,2013,3,0,19,22
Utah,2012,4,0,16,20
Utah,2011,4,1,10,15
Utah,2010,2,5,11,18
Utah,2009,2,5,11,18
Utah,2008,4,5,19,28
Utah,2007,4,1,21,26
Utah,2006,4,2,20,26
Utah,2005,7,2,17,26
Utah,2004,11,3,13,27
Utah,2003,6,4,52,62
Utah,2002,7,2,44,53
Utah,2001,8,3,43,54
Utah,2000,4,2,45,51
Utah,1999,6,3,41,50
Utah,1998,3,3,39,45
Vermont,2017,1,0,6,7
Vermont,2016,2,0,3,5
Vermont,2015,3,0,4,7
Vermont,2014,1,0,4,5
Vermont,2013,1,0,3,4
Vermont,2012,1,1,2,4
Vermont,2011,2,0,2,4
Vermont,2010,1,1,0,2
Vermont,2009,1,1,0,2
Vermont,2008,6,2,1,9
Vermont,2007,7,1,0,8
Vermont,2006,8,2,1,11
Vermont,2005,6,0,1,7
Vermont,2004,3,0,2,5
Vermont,2003,2,0,7,9
Vermont,2002,1,0,5,6
Vermont,2001,1,0,6,7
Vermont,2000,2,0,6,8
Vermont,1999,4,0,8,12
Vermont,1998,3,0,5,8
Virgin Islands,2017,0,0,1,1
Virginia,2017,133,7,77,217
Virginia,2016,133,8,41,182
Virginia,2015,128,4,42,174
Virginia,2014,123,3,39,165
Virginia,2013,112,4,43,159
Virginia,2012,81,5,48,134
Virginia,2011,61,5,40,106
Virginia,2010,56,2,36,94
Virginia,2009,56,2,36,94
Virginia,2008,67,4,36,107
Virginia,2007,68,4,29,101
Virginia,2006,69,1,24,94
Virginia,2005,74,0,33,107
Virginia,2004,58,2,33,93
Virginia,2003,74,9,78,161
Virginia,2002,77,8,74,159
Virginia,2001,86,8,73,167
Virginia,2000,91,4,69,164
Virginia,1999,89,2,60,151
Virginia,1998,101,7,56,164
Washington,2017,60,2,82,144
Washington,2016,67,4,38,109
Washington,2015,61,5,34,100
Washington,2014,63,5,35,103
Washington,2013,43,8,34,85
Washington,2012,31,8,40,79
Washington,2011,26,7,31,64
Washington,2010,22,4,33,59
Washington,2009,22,4,33,59
Washington,2008,23,6,30,59
Washington,2007,29,4,33,66
Washington,2006,32,1,25,58
Washington,2005,25,1,19,45
Washington,2004,32,1,10,43
Washington,2003,29,2,54,85
Washington,2002,22,1,54,77
Washington,2001,23,2,48,73
Washington,2000,13,3,39,55
Washington,1999,11,4,33,48
Washington,1998,8,4,36,48
West Virginia,2017,1,3,12,16
West Virginia,2016,0,3,8,11
West Virginia,2015,4,0,5,9
West Virginia,2014,4,0,6,10
West Virginia,2013,5,0,6,11
West Virginia,2012,7,0,8,15
West Virginia,2011,4,1,7,12
West Virginia,2010,4,1,5,10
West Virginia,2009,4,1,5,10
West Virginia,2008,5,0,5,10
West Virginia,2007,5,0,5,10
West Virginia,2006,5,0,3,8
West Virginia,2005,5,1,5,11
West Virginia,2004,6,0,3,9
West Virginia,2003,5,0,9,14
West Virginia,2002,6,1,9,16
West Virginia,2001,5,1,9,15
West Virginia,2000,5,1,8,14
West Virginia,1999,7,0,7,14
West Virginia,1998,7,0,9,16
Wisconsin,2017,66,17,87,170
Wisconsin,2016,60,14,65,139
Wisconsin,2015,61,14,64,139
Wisconsin,2014,65,15,71,151
Wisconsin,2013,60,16,68,144
Wisconsin,2012,69,13,77,159
Wisconsin,2011,67,13,75,155
Wisconsin,2010,50,7,77,134
Wisconsin,2009,50,7,77,134
Wisconsin,2008,48,4,51,103
Wisconsin,2007,56,4,47,107
Wisconsin,2006,61,3,49,113
Wisconsin,2005,54,3,41,98
Wisconsin,2004,54,4,34,92
Wisconsin,2003,59,7,97,163
Wisconsin,2002,66,9,93,168
Wisconsin,2001,63,13,83,159
Wisconsin,2000,63,10,80,153
Wisconsin,1999,70,5,91,166
Wisconsin,1998,72,5,84,161
Wyoming,2017,3,0,5,8
Wyoming,2016,1,0,3,4
Wyoming,2015,1,0,2,3
Wyoming,2014,1,0,1,2
Wyoming,2013,0,1,2,3
Wyoming,2012,1,1,0,2
Wyoming,2011,1,1,0,2
Wyoming,2010,2,0,0,2
Wyoming,2009,2,0,0,2
Wyoming,2008,1,0,0,1
Wyoming,2007,1,0,0,1
Wyoming,2006,1,0,0,1
Wyoming,2005,2,0,1,3
Wyoming,2004,3,0,2,5
Wyoming,2003,1,1,6,8
Wyoming,2002,0,1,4,5
Wyoming,2001,0,1,6,7
Wyoming,2000,1,0,5,6
Wyoming,1999,1,1,5,7
Wyoming,1998,0,1,5,6
